lang=language
defaultNetwork=defaultGateNetwork
use-mysql=
ignoreEntrance=
enableEconomy=economy.useEconomy
portal-save-location=folders.portalFolder
portal-folder=folders.portalFolder
gate-folder=folders.gateFolder
default-gate-network=gates.defaultGateNetwork
destroyexplosion=gates.integrity.destroyedByExplosion
maxgates=gates.maxGatesEachNetwork
destMemory=gates.cosmetic.rememberDestination
ignoreEntrance=
gates.integrity.ignoreEntrance=
handleVehicles=gates.functionality.handleVehicles
sortLists=gates.cosmetic.sortNetworkDestinations
protectEntrance=gates.integrity.protectEntrance
enableBungee=gates.functionality.enableBungee
verifyPortals=gates.integrity.verifyPortals
signColor=gates.cosmetic.signColor
gates.cosmetic.signColor=gates.cosmetic.mainSignColor
debug=debugging.debug
permdebug=debugging.permissionDebug
useiconomy=economy.useEconomy
useeconomy=economy.useEconomy
cost-to-use=economy.useCost
cost-to-create=economy.createCost
createcost=economy.createCost
destroycost=economy.destroyCost
usecost=economy.useCost
toowner=economy.toOwner
cost-destination=economy.chargeFreeDestination
chargefreedestination=economy.chargeFreeDestination
freegatesgreen=economy.freeGatesGreen
CheckUpdates=
economy.freeGatesGreen=economy.freeGatesColored
teleportMessage=
registerMessage=
destroyzMessage=
noownersMessage=
unselectMessage=
collisinMessage=
cantAffordToUse=
cantAffordToNew=
portal-open=
portal-closed=
cost-type=
cost-to-activate=
taxaccount=taxAccount
usevault=